0.0,0.0,400,400,25
109:108,1;109,1;110,1;111,1;112,1;113,1;114,1;115,1;116,1;117,1;118,1;119,1;120,1;121,1;122,1;123,1;124,1;125,1;126,1;127,1;128,1;129,1;130,1;131,1;132,1;133,1;134,1;135,1;136,1;137,1;138,1;139,1;140,1;141,1;142,1;143,1;144,1;145,1;146,1;147,1;148,1;149,1;150,1;151,1;152,1;153,1;154,1;155,1;156,1;157,1;158,1;159,1;160,1;161,1;162,1;163,1;164,1;165,1;166,1;167,1;168,1;169,1;170,1;171,1;173,1;174,1;175,1;176,1;177,1;178,1;179,1;180,1;181,1;182,1;183,1;184,1;185,1;186,1;187,1;188,1;189,1;190,1
110:108,1;124,1;156,1;171,1;173,1;190,1
111:108,1;124,1;156,1;171,1;173,1;190,1
112:108,1;156,1;171,1;173,1;190,1
113:108,1;171,1;173,1;190,1
114:97,1;98,1;99,1;100,1;101,1;102,1;103,1;104,1;105,1;106,1;107,1;108,1;171,1;173,1;190,1
115:97,1;171,1;173,1;190,1
116:97,1;171,1;173,1;190,1
117:97,1;171,1;173,1;190,1
118:97,1;118,1;119,1;120,1;121,1;122,1;123,1;124,1;125,1;126,1;127,1;128,1;129,1;130,1;131,1;171,1;173,1;190,1
119:97,1;118,1;131,1;156,1;157,1;158,1;159,1;160,1;161,1;162,1;163,1;164,1;165,1;166,1;167,1;168,1;169,1;170,1;171,1;173,1;174,1;175,1;176,1;177,1;178,1;179,1;180,1;181,1;182,1;190,1
120:97,1;118,1;131,1;156,1;182,1;190,1
121:97,1;118,1;131,1;156,1;158,0;159,0;160,0;161,0;162,0;163,0;164,0;165,0;166,0;167,0;168,0;169,0;170,0;171,0;172,0;173,0;174,0;175,0;176,0;182,1;190,1
122:97,1;118,1;131,1;156,1;158,0;176,0;182,1;190,1
123:97,1;118,1;131,1;156,1;158,0;176,0;182,1;190,1
124:97,1;118,1;131,1;156,1;158,0;176,0;182,1;190,1
125:97,1;118,1;131,1;156,1;158,0;176,0;182,1;190,1
126:97,1;98,1;99,1;100,1;101,1;102,1;103,1;104,1;105,1;106,1;107,1;108,1;109,1;110,1;111,1;112,1;113,1;114,1;115,1;116,1;117,1;118,1;120,1;121,1;122,1;123,1;124,1;125,1;126,1;127,1;128,1;129,1;130,1;131,1;156,1;157,0;158,0;176,0;182,1;190,1
127:120,1;176,0;182,1;190,1
128:93,0;94,0;95,0;96,0;97,0;98,0;99,0;100,0;101,0;102,1;103,1;104,1;105,1;106,1;107,1;108,0;109,1;110,1;111,1;112,1;113,1;114,1;115,1;116,1;117,1;118,1;119,1;120,1;176,0;182,1;190,1
129:93,0;108,0;176,0;182,1;190,1
130:93,0;108,0;176,0;182,1;190,1
131:93,0;176,0;182,1;190,1
132:93,0;176,0;182,1;190,1
133:93,0;129,1;130,1;131,1;132,1;133,1;134,1;135,1;136,1;137,1;138,1;139,1;140,1;141,1;142,1;143,1;144,1;145,1;146,1;147,1;148,1;149,1;150,1;151,1;152,1;153,1;154,1;155,1;156,0;157,0;158,0;159,0;160,0;161,0;162,0;163,0;164,0;165,0;166,0;167,0;168,0;169,0;170,0;171,0;172,0;173,0;174,0;175,0;176,0;182,1;190,1
134:93,0;129,1;182,1;190,1
135:93,0;129,1;182,1;190,1
136:93,0;129,1;182,1;190,1
137:93,0;94,0;95,0;96,0;101,0;102,0;103,0;104,0;105,0;106,0;107,0;108,1;109,1;110,1;111,1;112,1;113,1;114,1;115,1;116,1;117,1;118,1;119,1;120,1;121,1;122,1;123,1;124,1;125,1;126,1;127,1;128,1;129,1;182,1;190,1
138:93,1;101,0;182,1;190,1
139:93,1;101,1;102,1;103,1;104,1;105,1;106,1;107,1;108,1;109,1;110,1;111,1;112,1;113,1;114,1;115,1;116,1;117,1;118,1;119,1;120,1;121,1;122,1;123,1;124,1;125,1;126,1;127,1;128,1;129,1;130,1;131,1;132,1;133,1;134,1;135,1;136,1;137,1;138,1;139,1;140,1;141,1;142,1;143,1;144,1;145,1;146,1;147,1;148,1;149,1;150,1;151,1;152,1;153,1;154,1;155,1;156,1;157,1;158,1;159,1;160,1;161,1;162,1;163,1;164,1;165,1;166,1;167,1;168,1;169,1;170,1;171,1;172,1;173,1;174,1;175,1;176,1;177,1;178,1;179,1;180,1;181,1;182,1;190,1
140:93,1;190,1
141:93,1;190,1
142:93,1;190,1
143:93,1;190,1
144:93,1;190,1
145:93,1;190,1
146:93,1;190,1
147:93,1;190,1
148:93,1;94,1;95,1;96,1;97,1;98,1;99,1;100,1;101,1;102,1;103,1;104,1;105,1;106,1;107,1;108,1;109,1;110,1;111,1;112,1;113,1;114,1;115,1;116,1;117,1;118,1;119,1;120,1;121,1;122,1;123,1;124,1;125,1;126,1;127,1;128,1;129,1;130,1;131,1;132,1;133,1;134,1;135,1;136,1;137,1;138,1;139,1;140,1;141,1;142,1;143,1;144,1;145,1;146,1;147,1;148,1;149,1;150,1;151,1;152,1;153,1;154,1;155,1;156,1;157,1;158,1;159,1;160,1;161,1;162,1;163,1;164,1;165,1;166,1;167,1;168,1;169,1;170,1;171,1;172,1;173,1;174,1;175,1;176,1;177,1;178,1;179,1;180,1;181,1;182,1;183,1;184,1;185,1;186,1;187,1;188,1;189,1;190,1
::
::
Enter Elavator,2560.6721255183566:3150.0,0.0,0, 
Door,3912.5:3175.0,0.0,0, 
Door,3937.5:3175.0,0.0,0, 
Exit Elavator,4309.256845112272:3325.0,0.0,1, 
Button,3599.7158790596536:3325.0,0.0,0, 
Door,3287.5:3175.0,0.0,0, 
Companion Cube,3042.0383936565754:2922.5,0.0,0, 
Button,2833.1500399999995:3150.0,0.0,0, 
Button,3134.6972053066042:3425.0,0.0,0, 
Door,2712.5:3275.0,0.0,0, 
Door,3112.5:2800.0,0.0,0, 
Companion Cube Dispenser,3786.4782650027632:2750.0,0.0,0, 
Button,4153.2590102615795:2975.0,0.0,0, 
Door,3912.5:2825.0,0.0,0, 
Button,4449.5718278412205:2975.0,0.0,0, 
::
4,5
4,1
8,9
8,5
8,2
7,10
12,11
14,5
14,9
14,13
::
2725.0,2750.0
3100.0,2750.0
3100.0,2800.0
3125.0,2800.0
3125.0,2750.0
3900.0,2750.0
3900.0,2825.0
3925.0,2825.0
3925.0,2750.0
4275.0,2750.0
4275.0,2975.0
3900.0,2975.0
3900.0,3175.0
3975.0,3175.0
3975.0,3050.0
4400.0,3050.0
4400.0,3325.0
3225.0,3325.0
3225.0,3425.0
2525.0,3425.0
2525.0,3500.0
4575.0,3500.0
4575.0,2975.0
4350.0,2975.0
4350.0,2750.0
4750.0,2750.0
4750.0,3700.0
2350.0,3700.0
2350.0,3450.0
2425.0,3450.0
2425.0,3425.0
2350.0,3425.0
2350.0,3225.0
2700.0,3225.0
2700.0,3275.0
2725.0,3275.0
2725.0,3225.0
3025.0,3225.0
3025.0,3175.0
3300.0,3175.0
3300.0,2950.0
2950.0,2950.0
2950.0,3150.0
2450.0,3150.0
2450.0,2875.0
2725.0,2875.0
